流行を超える	により	登場により、
学習を繰り返す	は	（CI）は
進化を見せる	において	生成技術において
コンテンツ生成を行う	て	広がっており、
投資全額を上回る	へ	AI研究への
研究を進める	て	費やして
注目を集める	の	世間の
成功を受ける	の	松下電器の
知的制御を用いる	も	他社も
精度改善を果たす	が から	チームが 従来手法からの
専用プログラムを使う	の	単語の
行動型システムを用いる	から	環境から
認識能力を持つ	の	関係推論のような
注目を集める	の	世界中の
普及を受ける	の と	ディープラーニングの 発明と
機械学習を組み合わせる	て	リバースエンジニアリングして
投資を行う	で	民間企業主導で
研究を行う	を	神経回路を
実験をする	の や	AIの 研究や
弾圧を併せ持つ	と	資金力と
監視社会化を恐れる	の	同様の
差別を認める	の や	人工知能の 雇用や
判断を介す	から	観点から
禁止を求める	が	ヒューマン・ライツ・ウォッチが、
運用をめぐる	は	同会議は
自律無人艇を使う	に	6月には
話をする	と	幽霊と
意思疎通を行う	て	使っても、
勘違いをする	について	（不動点定理）について、
